312121111311322211221131211133131131111312
132213233332123233222222233123323221213123
222211123311231113113322312323313133212333
323121132321122313111321312232133232211132
113311111212313133212222313313131122233223
113233122313132133212232311212221233332122
312222232121223313221322311211312213323321
313311233132232313321131132122223223313323
133331232212322223312231233321222121333121
222111112312121312211322312323112323123221
333131211333231332313212113233232231123112
132222123131222312222122222133123311113121
112313231132321131132122233212323221111223
122132211311213231323331113121133321231313
321133211131211112332233223113122132312122
132221321233232312211323321122323331132132
122213113212233311133133133333312233221211
121121211111223221122312323313112121211221
333113222322221222223232213332132211123222
211332221233123122322213211213331123212232
131112131321313331311113233123311311212311
111111221222331211311312133221212122113232
322223221312111131222323231222131313331221
333113131231311323232333232321111332212131
232231221111322223331131321131213333221221
333112322131222332313123332111211123331113
231121322321323121332311313321331132231133
121311113311312331113113321333312212222211
331231211212211211211122333221322312333213
331122232311211333122212111122123221311312
132221232323333133121333111131312223333213
113211122211122232332121211232112121132311
122312112121231321232113223111223313332113
223211131212223231313321111221232121223113
213222323322123131221123113113133323222223
132332323112313221331333312231233123323323
231121313322311221311223212111131213331212
113232323331313131333122311232322331222122
323333333113213321222322131322221221113121
332131123312122221212223332133131331112333
232121132123123222332331312231132331111212
223112132222122232111231212232121232331233
